 , , , , , , , , , , , , , , , , 
 , , , , , , , , , , , , , , , , 
 , , , , , , , , , , , , , , , , 
 , , , , , , , , , , , , , , , , 
 , , , , , , , , , , ,N,N,N, , , 
 , , , , , ,N,N, , ,N,N, ,N, , , 
 , , , , ,~, ,N, , ,~, , ,N,N,N, 
 , , , , , , ,N, , ,~,X, ,N, , , 
 , , , ,M,~, ,N,N,N,N,N,N,N, , , 
 , , , , , , ,N, , , , , , , , , 
 , , , , , , , , , , , , ,~,~,~, 
 , , , , , , , , , , , , , , , , 
 , , , , , , , , , , , , , , , , 
 , , , , , , , , , , , , , , , , 
